"R..." ".K.." "..P." "...."
".." ".K"
"R..." "iheK" "...." "jeiR"

"...." "...." "..K." "...."
"K..." "...." "...." "...B"
"B..." "...." "...." "...K"
"K.Q." "...." "...." "...."
"...." ".K.." "...." "Q..."
"KP.." "...." "...." "...."
".P.." "K..." "...." "...."
"P..." ".K.." "...." "...."
"R..." "..." 
"K"
"Q..K" "...." "...." "...."
"R..K" ".BB." "...." "...."
